1111111111111111111111111111
1555555555555115555555555551
1611115111115115111115111161
1511115111115115111115111151
1555555555555555555555555551
1511115115111111115115111151
1511115115111111115115111151
1555555115555115555115555551
1111115111110110111115111111
1111115111110110111115111111
1111115110000000000115111111
1111115110111001110115111111
1111115110100000010115111111
3000005000100020010005000004
1111115110100000010115111111
1111115110111111110115111111
1111115110000000000115111111
1111115111110110111115111111
1111115111110110111115111111
1555555115555115555115555551
1511115115111111115115111151
1511115115111111115115111151
1555555555555555555555555551
1511115111115115111115111151
1611115111115115111115111161
1555555555555115555555555551
1111111111111111111111111111
0000000000000000000000000000
0000000000000000000000000000
0000000000000000000000000000
