111111111111111111111111111111
111115555555555555111115555503
111115111511111115111115111511
111115555556555555555655111511
111115111511111115111115111511
111115111511111115111115111511
111115111511111115111115111511
111115111511111115111115111511
111115111511111115111115111511
111115155555555555555515111511
111115151511111115111515111511
111115556555555555555555111511
111115151511111115111515111511
155555555550000005555555555511
151115151510002015111515111511
151115555550000005555555111511
151111151511111115111515111511
155565555555555555555555551504
151111151515111115111515151511
151111155555555555556515555511
151111111115111111111115151511
151111111115155555111115151511
151111111115151115111115151511
155565555555555555555555555511
151111111115151115111115151111
151111111115155555111115151111
151111111115111111111115151111
155555555555555555556666651111
111111111111111111111111111111
111111111111111111111111111111
